gophilter=yes
US=United States
CA=Canada
MX=Mexico
AR=Argentina
BR=Brazil
CL=Chile
CO=Colombia
PE=Peru
RU=Russia
IL=Israel
SA=Saudi Arabia
TR=Turkey
HK=Hong Kong
JP=Japan
KR=South Korea
TW=Taiwan
IN=India
ID=Indonesia
MY=Malaysia
PH=Philippines
SG=Singapore
TH=Thailand
VN=Vietnam
DK=Denmark
FI=Finland
IE=Ireland
SE=Sweden
GB=United Kingdom
AT=Austria
BE=Belgium
FR=France
DE=Germany
NL=Netherlands
CH=Switzerland
CZ=Czechia
HU=Hungary
PL=Poland
RO=Romania
UA=Ukraine
GR=Greece
IT=Italy
PT=Portugal
ES=Spain
AU=Australia
NZ=New Zealand
